ABOVE	AH B AH V
AHEAD	AH HH AE D
AREA	EH R IY AH
BACK	B AE K
BEHIND	B IH HH AY N D
BRIDGE	B R IH JH
COME	K AH M
FOR	F AO R
FOREST	F AO R IH S T
GO	G OW
KITE	K AY T
LAKE	L EY K
LEFT	L EA F T
LOOK	L UH K
MISSION	M IH SH AH N
NEXT	N EH K S T
OF	AH V
PICTURE	P IH K CH ER
RIGHT	R AY T
ROCK	R AA K
ROCKS   R AA K S
SCAN	S K EH N
SEA     S IY
SHOW	SH OW
START	S T AA R T
STOP	S T AA P
TAKE	T EY K
THAT	DH AE T
THE	DH AE
TO	T UW
TREE	T R IY
VICTIMS	V IH K T IH M Z
TUNNEL	T AH NN EH L
VICTIM	V IH K T IH M